S1111SSSSSSSSSSSSSSSSSSSSSSSSSSSSSSSSSSSSSSSSSSSSSSSSSSSSSSSSSSSSSSSSSSSSSSSSSSSSSSSSSSSSSSSSSSSSSSSSSSSSSSSSSSSSSSSSSSSSSSSSSSS
S111111111111111111111111111111111111111110011111111111111111111111111111111111111111111111111111111111111111111111001111111100S
S111111111111111111111111111111111111111110011111111111111111111111111111111111111111111111111111111111111111111111001111111100S
S1111111111111111111111111111T1111111111110011111111111111111111111111111111111111111111111111111111111111111111111GG1111111100S
S111111111111111111111111111111111111111110011111111111111111111111111111111111111111111111111111111111111111111111GG1111111100S
S1111GG00000000GG1111111111111111111111111001111GG00000000000GG1111111GG000000000000000000000000GG1111111111GG11111111111111100S
S1111GG00000000GG11111GG0000000GG111111111001111GG00000000000GG1111111GG000000000000000000000000GG1111111111GG11111111111111100S
S111111111111110011111GG0000000GG1111111110011110011111111111001111111001111111111111111111111110011111111110011111111111111100S
S111111111111110011111001111111001111111110011110011111111111001111GG0GG1111111111111111111111110011111111110011111111111111100S
S111111111111110011111001111111001111111110011110011111111111001111GG0GG1111111111111111111111110011111111110011111111111111100S
S111111111111110011111001111111001111111110011110011111111111001111111001111111111111111111111110011111111110011111111111111100S
S11111111111111001111100111b11100111111111001111001111111111100111111100111111111111111111111111GGGG00000000GG11111100011111100S
S0000000GG11111001111100111111100111111111001111001111111111100111111100111111111111111111111111GGGG00000000GG11111100011111100S
S0000000GG11111001111100111111100111111111001111GG11111111111001111111001111111GGGGGGGGGG11111110000111111111111111100011111100S
S111111100111110011111GG1111111GG000000000GG1111GG11111111111001111111001111111GGGGGGGGGG11111110000111111111111111111111111100S
S111111100111110011111GG1111111GG000000000GG11111111111GG1111001111111001111111GGGGGGGGGG11111110000111111111111111111111111100S
S111111100111110011111111111111111111111111111111111111GG1111001111111001111111111111111111111110000111111111111111111111111111S
S1111111001111100111111111111111111111111111111111111GGGG1111001111111001111111111111111111111110000111111111111111111111111111S
S1111111001111100111111111111111111111111111111111111GGGG1111001111111001111111111111111111111110000111111111111111111111111111S
S11111110011111001111111111111111111111111111111111GG00GG1111GG0GG1111GG1111111111111111111111110000111111111111111111111111111S
S11111110011111GG000GG0000000000000000GG00GG1111111GG00GG1111GG0GG1111GG11111111111111111111111100001111GGG11111111111111111111S
S11111110011111GG000GG0000000000000000GG00GG11111GG0000GG11111111111111111111111111111111111111100001111GGG11111111111111111111S
S111111100111111111100111111111111111100111111111GG0000GG111111111111111111111111111111111111111GGGG1111GGG1111GG00000000000000S
S1111111001111111111001111111111111111001111111GGGGGGGGGG111111111111111111111111111111111111111GGGG1111GGG1111GG00000000000000S
S1111111001111111111GG1111111111111111GG1111111GGGGGGGGGG11111111111111111111111111111111111111111001111GGG11111111111111111111S
S1111111001111111111GG1111111111111111GG111111111111111111111GG0GG11111111111111111111111111111111001111GGG11111111111111111111S
S1111111001111111111111111111GG111111111111111111111111111111GG0GG1111GG00000000XXXXXXXXXXXXXXXXXXXX1111GGG11111111111111111111S
S1111111GG0000GG1111111111111GG111111111111111111111111111111001111111GG00000000XXXXXXXXXXXXXXXXXXXX1111GGG11111111111111111111S
S1111111GG0000GG1111111111111001111111111111111111111111111110011111111111111111XX1111111111111111XX1111GGG11111111111111111111S
S1111111111111111111111111111001111111111111111111111GG000000GG11111111111111111XX1111111111111111XX1111GGG11111111111111111111S
S1111111111111111111GG0000000GG00000000000GG111111111GG000000GG11111111111111111XX1111111111111111XX1111111111111111111111GG000S
S1111111111111111111GG0000000GG00000000000GG111111111111111110011111111111111111XX1111111111111D11111111111111111111111111GG000S
S11111111111111111111111111111111111111111001111R1111111111110011111111111111111XX111111111111111111111111111111111111111111111S
S1111111111111111111111111111111111111111100111111111111111110011111111111111111XX111111111111111111111111111111111111111111111S
S1111111111111111111111111111111111111111100111111111111111110011111111111111111XX111111111111111111111111111111111111111111111S
S11111111111111111111111111111111111111111GG000000GG11111111100111111GG00000GG00XXXXXXXXXXXXXXXXXXXX000000000000GG1111111111111S
S11111100111111111111111111111111111111111GG000000GG11111111100111111GG00000GG00XXXXXXXXXXXXXXXXXXXX000000000000GG1111111111111S
S111111001111111111111111111111111111111110011111111111111111001111110011111001111111111111111111111111111111111111111111111111S
S111111001111111111111111111111111111111110011111111111111111001111110011111001111111111111111111111111111111111111111111111111S
S111111001111111111111111111111111111111110011111111111111GG0GG1111110011111001111111111111111111111111111111111111111111111111S
S000000GG0000GG000000000000000000000000000GG11111111111111GG0GG1111110011111001111111111111111111111111111111111111111111111111S
S000000GG0000GG000000000000000000000000000GG1111111111111111100111111GG11111GG1111111111111111111111111111111111111111111111111S
S11111100111111111111111111111111111111111111111111111111111100111111GG11111GG11111111111111111111111111111111111111111111GG000S
S1111110011111111111111111111111111111111111111111111111111110011111111111111111111111111111111111111111111111111111111111GG000S
S111111001111111111111111111111111111111111111111111111111111001111111111111111111111111111111111111111111111111111111111111111S
S11111100111111111111111111111111111111111111111GG0000GG111110011111111111111111111GG00000000000000GG111111GGGGGGGGGGG111111111S
S111111Xd1111XXXXXXXXXXXXXXXXXXXXXXXXXXXX1111111GG0000GG111110011111111111111111111GG00000000000000GG111111GGGGGGGGGGG111111111S
S111111XX1111XXXXXXXXXXXXXXXXXXXXXXXXXXXX11111GG11111100111110011111111111111111111001111111111111100111111GGGGGGGGGGG111111111S
S111111XX111111111111111111111111111111XX11111GG111111GG11111001111111111111111111100111111111111110011111111111111111111111111S
S111111XX111111111111111111111111111111XX1111100111111GG111110011111111GG11111111GGGG111111111111110011111111111111111111111111S
S111111XX111111111111111111111111111111XX111110011111111111110011111111GG11111111GGGG111111111111110011111111111111111111111111S
S111111XX111111111111111111111111111111XX11111GG0GG11111111110011111111001111111100001111GGGGGG11110011111111111111111111111111S
S111111XX111111111111111111111111111111XX11111GG0GG11111111110011111111001111111100001111GGGGGG11110011111111111111111111111111S
S111111XX111111111111111111111111111111XX111110011111111111110011111111001111111100001111GGGGGG11110011111111111111111111111111S
S111111XX111111111111111111111111111111XX11111001111111111111001111111100111111110000111111111111110011111111111111111111111111S
S111111XXXXXXXXXXXXXXXXXXXXXXXXXXXXXXXXXX11111GG111111GG11111GG00GG1111GG00000000GGGG11111111111111GG00000000000000GG0000000000S
S111111XXXXXXXXXXXXXXXXXXXXXXXXXXXXXXXXXX11111GG111111GG11111GG00GG1111GG00000000GGGG11111111111111GG00000000000000GG0000000000S
S111111GG1111111111111111111GG111111111GG11111111111GGGG11111001111111111111111111100111111111111111111111111111111001111111111S
S111111GG1111111111111111111GG111111111GG11111111111GGGG11111001111111111111111111100111111111111111111111111111111GG1111111111S
S1111110011111111111111111110011111111100111111111GG00GG11111001111111111111111111111111111111111111111111111111111GG1111111111S
S1111110011111111111111111110011111111100111111111GG00GG11111001111111111111111111111111111111111111111111111111111111111111111S
S11111100111111111111111111100111111111001111111GG0000GG111110011111GG11111GG11111111111111GG1111111111111111111111111111111111S
S1111110011111111GG11111111100111111111001111111GG0000GG111110011111GG11111GG11111111111111GG1111111111111111111111111111111111S
S1111110011111111GG111111111001111111110011111GGGGGGGGGG11111001111100111110011111111111111001111111111111111111111111111111111S
S111111GG1111111100111111111GG111111111GG11111GGGGGGGGGG11111GG00000GG00000GG00000000000000GG0000000000000000000000000GG1111111S
S111111GG1111111100111111111GG111111111GG11111111111111111111GG00000GG00000GG00000000000000GG0000000000000000000000000GG1111111S
S111111111111111100111111111111111111111111111111111111111111001111111111111111111111111111111111111111111111111111111111111111S
S111111111111111100111111111111111111111111111111111111111111001111111111111111111111111111111111111111111111111111111111111111S
S111111111111111100111111111111111111111111111111111111111111001111111111111111111111111111111111111111111111111111111111111111S
S111111111111111100111111111111111111111111111111111111111111001111111111111111111111111111111111111111111111111111111111111111S
S111111111111111100111111111111111111111111111111111111111111001111111111111111111111111111111111111111111111111111111111111111S
SSSSSSSSSSSSSSSSSSSSSSSSSSSSSSSSSSSSSSSSSSSSSSSSSSSSSSSSSSSSSSSSSSSSSSSSSSSSSSSSSSSSSSSSSSSSSSSSSSSSSSSSSSSSSSSSSSSSSSSSSSSSSSSS