CCCCCCCCCCCCCCCCCCCCCCCCCCCCCCCCCCCCCCCCCCCCCCCCCCCCCCCCCCCCCCCCCCCCCCCCCCCCCCCCCCCCCCCCCCCCCCCCCCCCCCCCCCCCCCCCCCCCCCCCCCCCCCCC
C1111AA000000000000000000000000000000000000AA0000000000BBBBBBB11111BBBBBBB11111111111111111111111111111111111111111111111111111C
C1111AA000000000000000000000000000000000000AA0000000000BBBBBBB11111BBBBBBB11111111111111111111111111111111111111111111111111111C
C111111111111111111111111111111111111111111001111111111BB000BB11111BB000BB11111111111111111111111111111111111111111111111111111C
C111111111111111111111111111111111111111111001111111111BB0A0BB11111BB0A0BB11111111111111111111111111111111111111111111111111111C
C111111111111111111111111111111111111111111AA1111111111BB000BB11111BB000BB1111AA00000000000000000000000000000000000000AA1111111C
C111111111111111111111111111111111111111111AA1111111111BBBBBBB11111BBBBBBB1111AA00000000000000000000000000000000000000AA1111111C
C1111AA1111AA000000000000000000000000AA1111111111111111BBBBBBB11111BBBBBBB11111111111111111111111111111111111111111111001111111C
C1111AA1111AA000000000000000000000000AA1111111111111111111111111111111111111111111111111111111111111111111111111111111001111111C
C111100111100111111111111111111111111001111111111111111111111111111111111111111111111111111111111111111111111111111111AA1111111C
C111100111100111111111111111111111111001111111111111111111111111111111111111111111111111111111111111111111111111111111AA1111111C
C11110011110011111111111111111111111100111111111111111111111111111111111111111111111111AA00000000000000000000000AA1111111111111C
C11110011110011111111111111111111111100111111111111111111111111111111111111111111111111AA00000000000000000000000AA1111111111111C
C111100111100111111111111111111111111001111111111BBBBBBBBBBBBB11111BBBBBBBBBBBBB11111110011111111111111111111111001111111111111C
C1111001111001111AA000000000000000000AA1111AA1111BBBBBBBBBBBBB11111BBBBBBBBBBBBB11111110011111111111111111111111001111111111111C
C1111001111001111AA000000000000000000AA1111AA1111BB000000000BB11111BB000000000BB11111110011111111111111111111111001111AA1111111C
C111100111100111111111111111111111111111111001111BB000000000BB11111BB000000000BB11111110011111111111111111111111001111AA1111111C
C111100111100111111111111111111111111111111001111BB000000000BB11111BB000000000BB11111110011110000000000000000000AA1111001111111C
C111100111100111111111111111111111111111111001111BB000000000BB11111BB000000000BB11111110011110000000000000000000AA1111001111111C
C111100111100111111111111111111111111111111001111BB000000000BB11111BB000000000BB11111110011111111111111111111111111111001111111C
C111100111100111111111111111111111111111111001111BB000000000BB11111BB000000000BB11111110011111111111111111111111111111001111111C
C1111AA0000AA00000AA1111AA00000000000000000AA0000BBBBBBBBBBBBB11111BBBBBBBBBBBBB11111110011111111111111111111111111111001111111C
C1111AA0000AA00000AA1111AA00000000000000000AA0000BBBBBBBBBBBBB11111BBBBBBBBBBBBB11111110011111111111111111111111111111001111111C
C11111111111111111111111AA1111111111111111111111111111111111111111111111111111111111111AA00000000000AA1111AA0000000000AA1111111C
C11111111111111111111111AA1111111111111111111111111111111111111111111111111111111111111AA00000000000AA1111AA0000000000AA1111111C
C111111111111111111111111111111111111111111111111111111111111111111111111111111111111111111111111111001111001111111111111111111C
C111111111111111111111111111111111111111111111111111111111111111111111111111111111111111111111111111001111001111111111111111111C
C111111111111111111111111111111111111111111111111111111111111111111111111111111111111111111111111111AA1111001111111111111111111C
C11111111111111111111111111111111111111111111111BBBBBBBBBBBBBB11111BBBBBBBBBBBBBB1111111111111111111AA1111001111111111111111111C
C1111AA1111AA0000000000000000000000AA11111111111BBBBBBBBBBBBBB11111BBBBBBBBBBBBBB1111111111111111111111111111111111111111111111C
C1111AA1111AA0000000000000000000000AA11111111111BB0000000000BB11111BB0000000000BB1111111111111111111111111111111111111111111111C
C11110011110011111111111111111111110011111111111BB0000000000BB11111BB0000000000BB1111111111111111111111111111111111111111111111C
C11110011110011111111111111111111110011111111111BBBBBBBBBBBBBB11111BBBBBBBBBBBBBB1111111111111111111111111111111111111111111111C
C11110011110011111111111111111111110011111111111BBBBBBBBBBBBBB11111BBBBBBBBBBBBBB11111111XXXXXXXXXXXXXXXXXXX1111111111111111111C
C1111001111001111111111111111111111001111111111111111111111111111111111111111111111111111XXXXXXXXXXXXXXXXXXX1111111111111111111C
C1111001111AA0000000000000000AA1111AA1111111111111111111111111111111111111111111111111111XX111111111111D11111111111111111111111C
C1111001111AA0000000000000000AA1111AA1111111111111111111111111111111111111111111111111111XX111111111111111111111111111111111111C
C1111001111111111111111111111111111111111111111111111111111111111111111111111111111111111XX111111111111111111111111111111111111C
C11110011111111111111111111111111111111111111111BBBBBBBBBBBBBB11111BBBBBBBBBBBBBB11111111XX111111111111111111111111111111111111C
C1111001111111111111111111111p111111111111111111BBBBBBBBBBBBBB11111BBBBBBBBBBBBBB11111111XX1111XXXXXXXXXXXXXXXXXXXXXXXXXXX11111C
C11110011111111111111111111111111111111111111111BB0000000000BB11111BB0000000000BB11111111XX1111XXXXXXXXXXXXXXXXXXXXXXXXXXX11111C
C1111AA000000000000000000AA1111AA00AA11111111111BB0000000000BB11111BB0000000000BB11111111XX11111111111111111111111111111XX11111C
C1111AA000000000000000000AA1111AA00AA11111111111BBBBBBBBBBBBBB11111BBBBBBBBBBBBBB11111111XX11111111111111111111111111111XX11111C
C11111111111111111111111111111100111111111111111BBBBBBBBBBBBBB11111BBBBBBBBBBBBBB11111111XX11111111111111111111111111111XX11111C
C1111111111111111111111111111110011111111111111111111111111111111111111111111111111111111XX11111111111111111111111111111XX11111C
C1111111111111111111111111111110011111111111111111111111111111111111111111111111111111111XX11111111111111111111111111111XX11111C
C11111111111111111111111111111100111111111111111111111111111111111111111111111111b1111111XX11111111111111111111111111111XX11111C
C1111AA000000000000000000000000AA11111111111111111111111111111111111111111111111111111111XX11111111111111111111111111111XX11111C
C1111AA000000000000000000000000AA111111111111111BBBBBBBBBBBBBB11111BBBBBBBBBBBBBB11111111XX11111111111111111111111111111XX11111C
C11110011111111111111111111111111111111111111111BBBBBBBBBBBBBB11111BBBBBBBBBBBBBB11111111XX11111111111111111111111111111XX11111C
C11110011111111111111111111111111111111111111111BB0000000000BB11111BB0000000000BB11111111XX11111111111111111111111111111XX11111C
C11110011111111111111111111111111111111111111111BB0000000000BB11111BB0000000000BB11111111XXXXXXXXXXXXXXXXXXXXXXXXXXXXXXXXX11111C
C11110011111111111111111111111111111111111111111BBBBBBBBBBBBBB11111BBBBBBBBBBBBBB11111111XXXXXXXXXXXXXXXXXXXXXXXXXXXXXXXXX11111C
C1111Xd1111XXXXXXXXXXXXXXXXXXXXXXXXXXXX111111111BBBBBBBBBBBBBB11111BBBBBBBBBBBBBB1111111111111111111111111111111111AA1111111111C
C1111XX1111XXXXXXXXXXXXXXXXXXXXXXXXXXXX1111111111111111111111111111111111111111111111111111111111111111111111111111AA1111111111C
C1111XX111111111111111111111111111111XX111111111111111111111111111111111111111111111111111111111111111o111111111111001111111111C
C1111XX111111111111111111111111111111XX111111111111111111111111i111111111111111111111111111111111111111111111111111001111111111C
C1111XX111111111111111111111111111111XX11111111111111111111111111111111111111111111111111AA000000000000000000AA1111AA1111111111C
C1111XX111111111111111111111111111111XX111111111BBBBBBBBBBBBBB11111BBBBBBBBBBBBBB11111111AA000000000000000000AA1111AA1111111111C
C1111XX111111111111111111111111111111XX111111111BBBBBBBBBBBBBB11111BBBBBBBBBBBBBB1111111100111111111111111111111111111111111111C
C1111XX111111111111111111111111111111XX111111111BB0000000000BB11111BB0000000000BB1111111100111111111111111111111111111111111111C
C1111XX111111111111111111111111111111XX111111111BB0000000000BB11111BB0000000000BB1111111100111111111111111111111111111111111111C
C1111XX111111111111111111111111111111XX111111111BBBBBBBBBBBBBB11111BBBBBBBBBBBBBB1111111100111111111111111111111111111111111111C
C1111XX111111111111111111111111111111XX111111111BBBBBBBBBBBBBB11111BBBBBBBBBBBBBB11111111001111AA00000000000000000000000AA11111C
C1111XX111111111111111111111111111111XX11111111111111111111111111111111111111111111111111001111AA00000000000000000000000AA11111C
C1111XXXXXXXXXXXXXXXXXXXXXXXXXXXXXXXXXX1111111111111111111111111111111111111111111111111100111111111111111111111111111110011111C
C1111XXXXXXXXXXXXXXXXXXXXXXXXXXXXXXXXXX1111111111111111111111111111111111111111111111111100111111111111111111111111111110011111C
C111111111111111111111111111111111111111111111111111111111111111111111111111111111111111100111111111111111111111111111110011111C
C11111111111111111111111111111111111111111111111BBBBBBBBBBBBBB11111BBBBBBBBBBBBBB1111111100111111111111111111111111111110011111C
C11111111111111111111111111111111111111111111111BBBBBBBBBBBBBB11111BBBBBBBBBBBBBB11111111AA00000000000000000000000000000AA11111C
C11111111111111111111111111111111111111111111111BB0000000000BB11111BB0000000000BB11111111AA00000000000000000000000000000AA11111C
CCCCCCCCCCCCCCCCCCCCCCCCCCCCCCCCCCCCCCCCCCCCCCCCCCCCCCCCCCCCCCCCCCCCCCCCCCCCCCCCCCCCCCCCCCCCCCCCCCCCCCCCCCCCCCCCCCCCCCCCCCCCCCCC