CCCCCCCCCCCCCCCCCCCCCCCCCCCCCCCCCCCCCCCCCCCCCCCCCCCCCCCCCCCCCC11111CCCCCCCCCCCCCCCCCCCCCCCCCCCCCCCCCCCCCCCCCCCCCCCCCCCCCCCCCCCCC
01111AA000000000000000000000000000000000000AA0000000000BBBBBBB11111BBBBBBB111111111111111111111111111111111111111111111111111110
01111AA000000000000000000000000000000000000AA0000000000BBBBBBB11111BBBBBBB111111111111111111111111111111111111111111111111111110
0111111111111111111111111111111111111111111001111111111BB000BB11111BB000BB111111111111111111111111111111111111111111111111111110
0111111111111111111111111111111111111111111001111111111BB0A0BB11111BB0A0BB111111111111111111111111111111111111111111111111111110
0111111111111111111111E11111111111111111111AA1111111111BB000BB11111BB000BB1111AA00000000000000000000000000000000000000AA11111110
0111111111111111111111111111111111111111111AA1111111111BBBBBBB11111BBBBBBB1111AA00000000000000000000000000000000000000AA11111110
01111AA1111AA000000000000000000000000AA1111111111111111BBBBBBB11111BBBBBBB111111111111111111111111111111111111111111110011111110
01111AA1111AA000000000000000000000000AA11111111111111111111111111111111111111111111111111111111111111111111111111111110011111110
0111100111100111111111111111111111111001111111111111111111111111111111111111111111111111111111111111111111111111111111AA11111110
0111100111100111111111111111111111111001111111111111111111111111111111111111111111111111111111111111111111111111111111AA11111110
011110011110011111111111111111111111100111111111111111111111111111111111111111111111111AA00000000000000000000000AA11111111111110
011110011110011111111111111111111111100111111111111111111111111111111111111111111111111AA00000000000000000000000AA11111111111110
0111100111100111111111111111111111111001111111111BBBBBBBBBBBBB11111BBBBBBBBBBBBB111111100111111111111111111111110011111111111110
01111001111001111AA000000000000000000AA1111AA1111BBBBBBBBBBBBB11111BBBBBBBBBBBBB111111100111111111111111111111110011111111111110
01111001111001111AA000000000000000000AA1111AA1111BB000000000BB11111BB000000000BB11111110011111111111111111111111001111AA11111110
0111100111100111111111111111111111111111111001111BB000000000BB11111BB000000000BB11111110011111111111111111111111001111AA11111110
0111100111100111111111111111111111111111111001111BB000000000BB11111BB000000000BB11111110011110000000000000000000AA11110011111110
0111100111100111111111111111111111111111111001111BB000000000BB11111BB000000000BB11111110011110000000000000000000AA11110011111110
0111100111100111111111111111111111111111111001111BB000000000BB11111BB000000000BB111111100111111111111111111111111111110011111110
0111100111100111111111111111111111111111111001111BB000000000BB11111BB000000000BB111111100111111111111111111111111111110011111110
01111AA0000AA00000AA1111AA00000000000000000AA0000BBBBBBBBBBBBB11111BBBBBBBBBBBBB111111100111111111111111111111111111110011111110
01111AA0000AA00000AA1111AA00000000000000000AA0000BBBBBBBBBBBBB11111BBBBBBBBBBBBB111111100111111111111111111111111111110011111110
011111111111111111111111AA1111111111111111111111111111111111111111111111111111111111111AA00000000000AA1111AA0000000000AA11111110
011111111111111111111111AA1111111111111111111111111111111111111111111111111111111111111AA00000000000AA1111AA0000000000AA11111110
01111111111111111111111111111111111111111111111111111111111111111111111111111111111111111111111111110011110011111111111111111110
01111111111111111111111111111111111111111111111111111111111111111111111111111111111111111111111111110011110011111111111111111110
0111111111111111111111111111111111111111111111111111111111111111111111111111111111111111111111111111AA11110011111111111111111110
011111111111111111111111111111111111111111111111BBBBBBBBBBBBBB11111BBBBBBBBBBBBBB1111111111111111111AA11110011111111111111111110
01111AA1111AA0000000000000000000000AA11111111111BBBBBBBBBBBBBB11111BBBBBBBBBBBBBB11111111111111111111111111111111111111111111110
01111AA1111AA0000000000000000000000AA11111111111BB0000000000BB11111BB0000000000BB11111111111111111111111111111111111111111111110
011110011110011111111111111111111110011111111111BB0000000000BB11111BB0000000000BB11111111111111111111111111111111111111111111110
011110011110011111111111111111111110011111111111BBBBBBBBBBBBBB11111BBBBBBBBBBBBBB11111111111111111111111111111111111111111111110
011110011110011111111111111111111110011111111111BBBBBBBBBBBBBB11111BBBBBBBBBBBBBB11111111XXXXXXXXXXXXXXXXXXX11111111111111111110
01111001111001111111111111111111111001111111111111111111111111111111111111111111111111111XXXXXXXXXXXXXXXXXXX11111111111111111110
01111001111AA0000000000000000AA1111AA1111111111111111111111111111111111111111111111111111XX111111111111D111111111111111111111110
01111001111AA0000000000000000AA1111AA1111111111111111111111111111111111111111111111111111XX1111111111111111111111111111111111110
01111001111111111111111111111111111111111111111111111111111111111111111111111111111111111XX1111111111111111111111111111111111110
011110011111111111111111111111111111111111111111BBBBBBBBBBBBBB11111BBBBBBBBBBBBBB11111111XX1111111111111111111111111111111111110
011110011111111111111111111111111111111111111111BBBBBBBBBBBBBB11111BBBBBBBBBBBBBB11111111XX1111XXXXXXXXXXXXXXXXXXXXXXXXXXX111110
011110011111111111111111111111111111111111111111BB0000000000BB11111BB0000000000BB11111111XX1111XXXXXXXXXXXXXXXXXXXXXXXXXXX111110
01111AA000000000000000000AA1111AA00AA11111111111BB0000000000BB11111BB0000000000BB11111111XX11111111111111111111111111111XX111110
01111AA000000000000000000AA1111AA00AA11111111111BBBBBBBBBBBBBB11111BBBBBBBBBBBBBB11111111XX11111111111111111111111111111XX111110
011111111111111111111111111111100111111111111111BBBBBBBBBBBBBB11111BBBBBBBBBBBBBB11111111XX11111111111111111111111111111XX111110
01111111111111111111111111111110011111111111111111111111111111111111111111111111111111111XX11111111111111111111111111111XX111110
01111111111111111111111111111110011111111111111111111111111111111111111111111111111111111XX11111111111111111111111111111XX111110
01111111111111111111111111111110011111111111111111111111111111111111111111111111111111111XX11111111111111111111111111111XX111110
01111AA000000000000000000000000AA11111111111111111111111111111111111111111111111111111111XX11111111111111111111111111111XX111110
01111AA000000000000000000000000AA111111111111111BBBBBBBBBBBBBB11111BBBBBBBBBBBBBB11111111XX11111111111111111111111111111XX111110
011110011111111111111111111111111111111111111111BBBBBBBBBBBBBB11111BBBBBBBBBBBBBB11111111XX11111111111111111111111111111XX111110
011110011111111111111111111111111111111111111111BB0000000000BB11111BB0000000000BB11111111XX11111111111111111111111111111XX111110
011110011111111111111111111111111111111111111111BB0000000000BB11111BB0000000000BB11111111XXXXXXXXXXXXXXXXXXXXXXXXXXXXXXXXX111110
011110011111111111111111111111111111111111111111BBBBBBBBBBBBBB11111BBBBBBBBBBBBBB11111111XXXXXXXXXXXXXXXXXXXXXXXXXXXXXXXXX111110
01111Xd1111XXXXXXXXXXXXXXXXXXXXXXXXXXXX111111111BBBBBBBBBBBBBB11111BBBBBBBBBBBBBB1111111111111111111111111111111111AA11111111110
01111XX1111XXXXXXXXXXXXXXXXXXXXXXXXXXXX1111111111111111111111111111111111111111111111111111111111111111111111111111AA11111111110
01111XX111111111111111111111111111111XX11111111111111111111111111111111111111111111111111111111111111111111111111110011111111110
01111XX111111111111111111111111111111XX11111111111111111111111111111111111111111111111111111111111111111111111111110011111111110
01111XX111111111111111111111111111111XX11111111111111111111111111111111111111111111111111AA000000000000000000AA1111AA11111111110
01111XX111111111111111111111111111111XX111111111BBBBBBBBBBBBBB11111BBBBBBBBBBBBBB11111111AA000000000000000000AA1111AA11111111110
01111XX111111111111111111111111111111XX111111111BBBBBBBBBBBBBB11111BBBBBBBBBBBBBB11111111001111111111111111111111111111111111110
01111XX111111111111111111111111111111XX111111111BB0000000000BB11111BB0000000000BB11111111001111111111111111111111111111111111110
01111XX111111111111111111111111111111XX111111111BB0000000000BB11111BB0000000000BB11111111001111111111111111111111111111111111110
01111XX111111111111111111111111111111XX111111111BBBBBBBBBBBBBB11111BBBBBBBBBBBBBB11111111001111111111111111111111111111111111110
01111XX111111111111111111111111111111XX111111111BBBBBBBBBBBBBB11111BBBBBBBBBBBBBB11111111001111AA00000000000000000000000AA111110
01111XX111111111111111111111111111111XX11111111111111111111111111111111111111111111111111001111AA00000000000000000000000AA111110
01111XXXXXXXXXXXXXXXXXXXXXXXXXXXXXXXXXX11111111111111111111111111111111111111111111111111001111111111111111111111111111100111110
01111XXXXXXXXXXXXXXXXXXXXXXXXXXXXXXXXXX11111111111111111111111111111111111111111111111111001111111111111111111111111111100111110
01111111111111111111111111111111111111111111111111111111111111111111111111111111111111111001111111111111111111111111111100111110
011111111111111111111111111111111111111111111111BBBBBBBBBBBBBB11111BBBBBBBBBBBBBB11111111001111111111111111111111111111100111110
011111111111111111111111111111111111111111111111BBBBBBBBBBBBBB11111BBBBBBBBBBBBBB11111111AA00000000000000000000000000000AA111110
011111111111111111111111111111111111111111111111BB0000000000BB11111BB0000000000BB11111111AA00000000000000000000000000000AA111110                                                                                                                                  
CCCCCCCCCCCCCCCCCCCCCCCCCCCCCCCCCCCCCCCCCCCCCCCCCCCCCCCCCCCCCC11111CCCCCCCCCCCCCCCCCCCCCCCCCCCCCCCCCCCCCCCCCCCCCCCCCCCCCCCCCCCCC