00000000000000000000000000000000000000000000000000000000000000000000000000000000000000000000000000000000000000000000000000000000
0TTTTTTTTTTTTTTTTTTTTTTTTTTTTTTTTTTTTTTTTTT11111100001111111110000001111100000000000111111111111111111111111000000000000000TTTT0
0TTTTTTTTTTTTTTTTTTTTTTTTTTTTTTTTTTTTTTTTTT11111100001111111110000001111100000000000111111111111111111111111000011111111000TTTT0
0TTTTTTTTTTTTTTTTTTTTTTTTTTTTTTTTTTTTTTTTTT01111100001111111110000001111100000000000111111111111111111111111111111111111000TTTT0
0TTTTTTTTTTTTTTTTTTTTTTTTTTTTTTTTTTTTTTTTTT01111100001111111110000001111100000000000111111111111111111111111111111111111000TTTT0
0TTTTTTTTTTTTTTTTTTTTTTTTTTTTTTTTTTTTTTT00001111100001111111110000001111100000000000111100000000000011111111111111111111000TTTT0
0TTTTTTTTTTTTT0000000000000000000000001100001111100001111111110000001111100000111111111100000000000011111111111111111111000TTTT0
0TTTTTTTTTTTTT0000000000000000000000001100001111100001111111110000001111100000111111111100000000000011111111000011111111000TTTT0
0TTTTTTTTTTTTT0000000000000000000000001100001111111111111111110000001111100000111111111100000000000011111111000000000000000TTTT0
0TTTTTTTTTTTTT0000000000000000000000001111111111111111111111111100111111100000111111111100000000000011111111111111111111111TTTT0
0TTTTTTTTTTTTT00000000000000000000000011111111111111111111111110000111111000001111111111000000000000111111111111111110000000TTT0
0TTTTTTTTTTTTT00000000000000000000000011111111111111111111111110000111111000001111111111000000000000111111111111111110000000TTT0
0TTTTTTTTTTTTT11111111111111111111111111111111111111111111111111111TTTTTTTTTTTTTTTTTTTTTTTTTTTTTTTTT111111111111111110000000TTT0
0TTTT00000000000001TTTTTTTTTTTTTTTTTTTTTTTTTTTTTTTTTTTTTTTTTTTT1111TTTTTTTTTTTTTTTTTTTTTTTTTTTTTTTTT111111111111111110000000TTT0
0TTTT01111111111001TTTTTTTTTTTTTTTTTTTTTTTTTTTTTTTTTTTTTTTTTTTT1111TTTTTTTTTTTTTTTTTTTTTTTTTTTTTTTTT111111111111111110000000TTT0
0TTTT01111111111001TTTTTTTTTTTTTTTTTTTTTTTTTTTTTTTTTTTTTTTTTTTT1111TTTTTTTTTTTTTTTTTTTTTTTTTTTTTTTTT111111111111111110000000TTT0
0TTTT01111111111111111111111111111111111111111111111111111111111111111111111111111111111111111111111111111111111111110000000TTT0
0TTTT011111111111111111111111111111111111111111111111111111111111111111111111111111111111111111111111111111111111111110000000TT0
0TTTT011111111111111111111111111111111111111111111111111111111111111111111111111111111111111111111111111111111111111110000000TT0
0TTTT011111111111111111111111111111111111111111111111111111111111111111111111111111111111111111111111111111111111111110000000TT0    D
0TTTT00111100000001TTTTTTTTTTTTTTTTTTTTTTTTTTTTTTTTTTTTTTTTTTTT1111TTTTTTTTTTTTTTTTTTTTTTTTTTTTTTTTT1111111111111111110000000TT0
0TTTT0011110TTTTTTTTTTTTTTTTTTTTTTTTTTTTTTTTTTTTTTTTTTTTTTTTTTT1111TTTTTTTTTTTTTTTTTTTTTTTTTTTTTTTTT1111111111111111110000000TT0
0TTTT0011110TTTTTTTTTTTTTTTTTTTTTTTTTTTTTTTTTTTTTTTTTTTTTTTTTTT1111TTTTTTTTTTTTTTTTTTTTTTTTTTTTTTTTT1111111111111111110000000TT0
0TTTT0011110TTTTTTTTTTTT11111111111111111111111111111111111111111111111111111111111111111111111111111111111111111111110000000TT0
0TTTTTT1111TTTTTTTTTTTTT111111111111111111111111111111111111111111111111111111111111111111111111111111111111111111111110000000T0
0TTTTTT1111TTTTTTTTTTTTT111111111111111111111111111111111111111111111111111111111111111111111111111111111111111111111110000000T0
0TTTTTT1111TTTTTTTTTTTTT111111111111111111111111111111111111111111111111111111111111111111111111111111111111111111111110000000T0
0TTTTTT1111TTTTTTTTTTTTT111111111111111111111110000000000000000111111000000000000000011111111111111111111111111111111110000000T0
0TTTTTT1111TTTTTTTTTTTTT111111111111111111111110000000000000000111111000000000000000011111111111111111111111111111111110000000T0
0TTTTTT1111TTTTTTTTTTTTT111111111111111111111110011111111111111111111111111111111110011111111111111111111111111111111110000000T0
0TTTTTT1111TTTTTTTTTTTTT111111111111111111111110011111111111111111111111111111111110011111111111111111111111111111111110000000T0
0TTTTTT1111TTTTTTTTTTTTT11110000000111111111111001111111111111111111111111111111111001111111111110000000111111111111111100000000
0TTTTTT1111TTTTTTTTTTTTT1111000000011111111p1110011111111111111111111111111111111110011111o1111110000000111111111111111100000000
0TTTTTT1111TTTTTTTTTTTTT11111111110111111111111001111100000000011111100000000011111001111111111110011111111111111111111100000000
0TTTTTT1111TTTTTTTTTTTTT11111111110111111111111001111100000000011111100000000011111001111111111110011111111111111111111100000000
0TTTTTT1111TTTTTTTTTTTTT11111111110000000000000001111100111111111111111111110011111000000000000000011111111111111111111100000000
0TTTTTT1111TTTTTTTTTTTTT11111111110000000000000001111100111111111111111111110011111000000000000000011111111111111111111100000000
0TTTTTT1111TTTTTTTTTTTTT11110011111111111111111111111111111111111111111111111111111111111111111111111100111111111111111100000000
0TTTTTT1111TTTTTTTTTTTTT11110011111111111111111111111111111111111111111111111111111111111111111111111100111111111111111111000TT0
0TTTTTT1111TTTTTTTTTTTTT11110011111111111111111111111111111111111111111111111111111111111111111111111100111111111111111111000TT0
0TTTTTT1111TTTTTTTTTTTTT11110011111111111111111111111111111111111111111111111111111111111111111111111100111111111111111111000TT0
0TTTTTT1111TTTTTTTTTTTTT11111111110000000000000001111100111111111111111111110011111000000000000000011111111111111111111111111TT0
0TTT0001111TTTTTTTTTTTTT11111111110000000000000001111100111111111111111111110011111000000000000000011111111111111111111111111TT0
0TTT0001111TTTTTTTTTTTTT11111111110111111111111001111100000000011111100000000011111001111111111110011111111111111111111111111TT0
0TTT0001111TTTTTTTTTTTTT11111111110111111111111001111100000000011111100000000011111001111111111110011111111111111111111111111TT0
01111111111TTTTTTTTTTTTT11110000000111111111111001111111111111111111111111111111111001111111111110000000111111111111111111111TT0
01111111111111111111111111110000000111111111111001111111111111111111111111111111111001111111111110000000111111111111111111111TT0
01111111111111111111111111111111111111111111111001111111111111111111111111111111111001111111111111111111111111111111111111111TT0
01111111111111111111111111111111111111111111111001111111111111111111111111111111111001111111111111111111111111111111111111111TT0
01111111111111111111111111111111111111111111111000000000000000011111100000000000000001111111111111111111111111111111111111111TT0
0000000111111111111111111111111111111111111111100000000000000001111110000000000000000111111i1111111111111111111111111111111111T0
000000011111111111111111111111111111111111111111111111111111111111111111111111111111111111111111111111111111111111111111111111T0
0000000TTTTTTT11111TTTTT111111111111111111111111111111111111111111111111111111111111111111111111111111111111111111111111111111T0
0TTTTTTTTTTTTT11111TTTTT111111111111111111111111111111111111111111111111111111111111111111111111111111111111111111111111111111T0
0TTTTTTTTTTTTT11111TTTTT111111111111111111111111111111111111111111111111111111111111111111111111111111111111111111111111111111T0
0TTTTTTTTTTTTT11111TTTTT111111111111111111111111111111111111111111111111111111111111111111111111111111111111111111111111111111T0
0TTTTTTTTTTTTT11111TTTTT111111111111111111111111111111111111111111111111111111111111111111111111111111111111111111111111111111T0
0TTTTTTTTTTTTT11111TTTTT111111111111111111111111111111111111111111111111111111111111111111111111111111111111111111111111111111T0
0TTTTTT0000TTT11111TTTTTTTTTTTTTTTTTTTTTTTTTTTTTTTTTTTTT1111111111111111TTTTTTTTTTTTTTTTTTTTTTTTTTTTTTTT0111110TTTTTTTTTTTTTTTT0
0TTTTTT0000TTT11111TTTTTTTTTTTTTTTTTTTTTTTTTTTTTTTTTTTTT1111111111111111TTTTTTTTTTTTTTTTTTTTTTTTTTTTTTTT0111110TTTTTTTTTTTTTTTT0
0TTTTTT0000TTT11111TTTTTTTTTTTTTTTTTTTTTTTTTTTTTTTTTTTTT1111111111111111TTTTTTTTTTTTTTTTTTTTTTTTTTTTTTTT0111110TTTTTTTTTTTTTTTT0
0TTTTTT0000TTT11111TTTTTTTTTTTTTTTTTTTTTTTTTTTTTTTTTTTTT1111111111111111TTTTTTTTTTTTTTTTTTTTTTTTTTTTTTTT0111110TTTTTTTTTTTTTTTT0
0TTTTTT0000TTT11111TTTTTTTTTTTTTTTTTTTTTTTTTTTTTTTTTTTTT1111111000111111TTTTTTTTTTTTTTTTTTTTTTTTTTTTTTTT0111110TTTTTTTTTTTTTTTT0
0TTTTTT0000TTT11111TTTTTTTTTTTTTTTTTTTTTTTTTTTTTTTTTTTTT1111111000111111TTTTTTTTTTTTTTTTTTTTTTTTTTTTTTTT0111110TTTTTTTTTTTTTTTT0
0TTTT000000TTT11111TTTTTTTTTTTTTTTTTTTTTTTTTTTTTTTTTTTTT0d11110000000000TTTTTTTTTTTTTTTTTTTTTTTTTTTTTTTT0111110TTTTTTTTTTTTTTTT0
0TTTT000000TTT11111TTTTTTTTTTTTTTTTTTTTTTTTTTTTTTTTTTTTT0111111111111110TTTTTTTTTTTTTTTTTTTTTTTTTTTTTTTT0000000TTTTTTTTTTTTTTTT0
0TTTT000000TTT11111TTTTTTTTTTTTTTTTTTTTTTTTTTTTTTTTTTTTT0111111111111110TTTTTTTTTTTTTTTTTTTTTTTTTTTTTTTT0111110TTTTTTTTTTTTTTTT0
0TTTT000000TTT11111TTTTTTTTTTTTTTTTTTTTTTTTTTTTTTTTTTTTT0111111111111110TTTTTTTTTTTTTTTTTTTTTTTTTTTTTTTT0111110TTTTTTTTTTTTTTTT0
0TTTT000000TTT11111TTTTTTTTTTTTTTTTTTTTTTTTTTTTTTTTTTTTT0111111111111110TTTTTTTTTTTTTTTTTTTTTTTTTTTTTTTT0111110TTTTTTTTTTTTTTTT0
0TTTT000000TTT11111TTTTTTTTTTTTTTTTTTTTTTTTTTTTTTTTTTTTT0111111111111110TTTTTTTTTTTTTTTTTTTTTTTTTTTTTTTT0111110TTTTTTTTTTTTTTTT0
0TTTTTTTTTTTTT11111TTTTTTTTTTTTTTTTTTTTTTTTTTTTTTTTTTTTT0111111111111110TTTTTTTTTTTTTTTTTTTTTTTTTTTTTTTT0111110TTTTTTTTTTTTTTTT0
00000000000000000000000000000000000000000000000000000000011111111111111000000000000000000000000000000000011111000000000000000000
